	[Common]
Invalid exe	错误的H3WMAPED.exe文件
"%s" is invalid	“%s”已损坏
"%s" not found	未找到“%s”
"%s" is missing or incorrect	未找到“%s”或者已损坏
"%s" is not a valid positive integer	“%s”必须是正整数
Advanced Properties Menu	高级属性...
WoG Tools	WoG工具
Exception Question	退出程序前保存地图吗？
(按取消可继续)
Unbind All Question	你确定要解绑所有事件吗？
Save Map Filter	英雄无敌3 WoG(*.h3m)|*.h3m|英雄无敌3 SoD(*.h3m)|*.h3m|所有文件(*.*)|*.*|
Validation: Enter Overlap	“(%d, %d, %d)入口封闭。”
物体的入口被另一个物体覆盖，这可能会在游戏中产生错误。

	[TRSLodEdt]
SDeleteQuestion	你真的要从档案中删除“%s”吗？
SDeleteManyQuestion	你真的要从档案中删除选中的文件吗？
SNewFolder	新建文件夹
SExtractAs	导出为...
Button1.Caption	确定
Button2.Caption	取消
AddFolder1.Caption	新建文件夹
AddFile1.Caption	添加文件
MergeFavorites1.Caption	合并到...
Cut1.Caption	剪切
Copy1.Caption	复制
Paste1.Caption	粘贴
Delete1.Caption	删除
Rename1.Caption	重命名
Select1.Caption	选择
Extract1.Caption	导出
ExtractTo1.Caption	导出到...
Delete2.Caption	删除
AddtoFavorites1.Caption	添加到收藏夹
File1.Caption	文件
New1.Caption	新建
Open1.Caption	打开
RecentFiles1.Caption	最近打开的文件
Exit1.Caption	退出
Edit1.Caption	编辑
Add1.Caption	添加
Extract2.Caption	导出
ExtractTo2.Caption	导出到...
Delete3.Caption	删除
AddtoFavorites2.Caption	添加到收藏夹
RSSpeedButton2.Hint	播放
RSSpeedButton1.Hint	拉伸

	[Advanced Properties]
StdPropsText	标准属性
NoStdPropsText	无标准属性
Caption	高级属性
RSSpeedButton1.Hint	从lod文件中选择图像
RSSpeedButton2.Hint	复制
RSSpeedButton3.Hint	粘贴
Label1.Caption	类型：
Label2.Caption	子类：
Label3.Caption	图像：
Label13.Caption	全部
CheckNone.Hint	全不选
CheckAll.Hint	全选
Label6.Caption	空
Label8.Caption	物体
Label9.Caption	入口
CheckBox1.Caption	地面的一部分
Button1.Caption	确定
Button2.Caption	取消
Button3.Caption	帮助

	[Events Binding]
BindText	绑定
UnbindText	解绑
BindHint	与脚本文件绑定
RSSpeedButton1.Hint	浏览
RSSpeedButton2.Hint	编辑
Label2.Caption	脚本文件：
BoundAutorefresh	这个事件和脚本文件绑定。
每次保存地图的时候，会更新脚本文件。
在保存了地图之后，每次更新脚本文件地图都会重新保存一次。查看帮助了解更多信息。
BoundNoAutorefresh	这个事件和脚本文件绑定。
每次保存地图的时候，会更新脚本文件。
如果启用了脚本自动刷新，每次更新脚本后不用重新保存地图。查看帮助了解更多信息。
OpenDialog1.Title	绑定

	[WoG Button Bar]
RSSpeedButton1.Hint	载入小地图图像
RSSpeedButton2.Hint	保存小地图图像
ButtonSingleSquares.Hint	允许单格地形
RSSpeedButton4.Hint	填充地图
ButtonExpandRoads.Hint	地图边缘可放置道路
ButtonRoads1.Hint	道路与河流可放置在任意地形
OpenPictureDialog1.PreviewButton.Hint	预览
SavePictureDialog1.PreviewButton.Hint	预览
ButtonCopyMap.Hint	复制地图区域
ButtonPasteMap.Hint	粘贴地图区域

	[CopyMap Bar]
RSSpeedButton1.Caption	取消
ButtonGround.Hint	粘贴地形
ButtonObjects.Hint	粘贴物体
LabelCopy1.Caption	选择矩形复制区域的左上角。
LabelCopy2.Caption	选择矩形复制区域的右下角。
LabelPaste.Caption	选择粘贴的位置。复制区域的左上角会被放在那里。
LabelCopyCaption.Caption	复制地图区域
LabelPasteCaption.Caption	粘贴地图区域
